==========================
==BDDD=====----=====DDDB==
==D==D====-====-====D==D==
==D=MD===-======-===DM=D==
==DDDDDDD==----==DDDDDDD==
=====DM=D==-==-==D=MD=====
=====D=MD==-==-==DM=D=====
=====DDDDWW-WW-WWDDDD=====
=----===-==-==-==-===----=
=-==-===-==-==-==-===-==-=
=-==-===----MM----===-==-=
=----================----=
==========================
