=MMMMMMMMMMMMMM=====
M--------------DDDB=
M-----MWWWWWWWWDDD==
=MMMMM=DDDDDDDDDDD==
=======DDDDDDDDDDD==
==DDDDDDDDDDDDDDDD==
==WWWWDDDWWDDDWWWW==
=MDDDDDDDDDDDDDDDDM=
=MDDDDDDDDDDDDDDDDM=
=MDWWWWWDDDDWWWWWDM=
=MDWWWWWDDDDWWWWWDM=
=MDDDDDDDDDDDDDDDDM=
=MDDDDDDDDDDDDDDDDM=
==WWWWDDDWWDDDWWWW==
==DDDDDDDDDDDDDDDD==
==DDDDDDDDDDD=======
==DDDDDDDDDDD=MMMMM=
==DDDWWWWWWWWM-----M
=BDDD--------------M
=====MMMMMMMMMMMMMM=
