BDDDDDDDDDDDMDDMDDDM
DD======DWWD=MDMDMDM
MDMDDDM=DDDD=MDMDMDM
MDMDMDM=WDDW=MDMDMDM
MDMDMDM=WDDW=MDMDMDM
MDMDMDM=DDDD=MDMDMDM
MDMDMDM=DWWD=MDMDMDM
MDMDMDM=DWWD=MDMDMDM
MDMDMDM=DDDD=MDMDMDM
MDMDMDM=WDDW=MDMDMDM
MDMDMDM=WDDW=MDMDMDM
MDMDMDM=DDDD=MDDDMDM
MDMDMDM=DWWD======DD
MDDDMDDMDDDDDDDDDDDB
