B=DDDDDDDDDDDDDDDDDDDD===
D=D=====DDD========DDDDD=
D=DD=-------------====DD=
D==D=-------------=DDDDD=
D=DD=-------------=DDD===
D=D==-------------=DDDDD=
D=DD=--------MMMMM====DD=
D==D=MMMMM=-=======DDDDD=
D=DD=======-------=DD====
D=D-WW------------=DDDDD=
D=D-WW------------====DD=
D=D-WW------------=DDDDD=
D=D-WW-==========D=DD====
D=D-WW-DDDDDDDDDDD=DDDDDD
D=D-WW-D===============DD
DDD-WW-DDDDDDDDDDDDDDDDDB
