BDDDDDDD=DDDDDD
DD=====D=DDDD=D
D==DDD=D=DDDD=D
D=DDDD=D=DDDD=D
D=DDDD=D=DDDD=D
D=DDDD=D=DDDD=D
D=DDDD=D=DDDD=D
D=DDDD=D=DDDD=D
D=DDDD=D=DDDD=D
D=DDDD=D=DDD==D
D=DDDD=D=====DD
DDDDDD=DDDDDDDB
