DDDDDDDDDDDD--DDDDDDDDDDD
DDDDDDDDDDDD=-DDDDDDDDDDD
DDDDDDDDDDDD=-DDDDDDDDDDD
DDDDDDDDDDDD=DDDDDDDDDDDD
DDDDDDDDDDDD=DDDDDDDDDDDD
DDD===================DDD
DDDDDDD-D-DB=BD-D-DDDDDDD
DDD=====-=============DDD
DDDDDDDD-DDD=DDDDDDDDDDDD
DDDDDDDD-DDD=DDDDDDDDDDDD
DDDDDDDDMDDD=DDDDDDDDDDDD
DDDDDDDDDDDD=DDDDDDDDDDDD
DDDDDDDDDDDD=DDDDDDDDDDDD
DDDDDDDDDDDD-DDDDDDDDDDDD
