B=D=DDD=DDD=M=DDD=DDD=D=B
DDD=D=D=D=D=-=D=D=D=D=DDD
=DDDD=DDD=D---D=DDD=DDDD=
=D==========M==========D=
=D=D=D=D=D=-=-=D=D=D=D=D=
=D-D-D-D-D--=--D-D-D-D-D=
=DD=D=D=D==-=-==D=D=D=DD=
===D=D=D=D=-=-=D=D=D=D===
DDDDDDDDDD-----DDDDDDDDDD
D=========-===-=========D
DDDDDDDDM=-=M=-=MDDDDDDDD
D======DD=-=D=-=DD======D
------==D=-=D=-=D==------
----M--=---------=--M----
