DDDDDDDDDD
DBBBBBDBDD
BBDBDDBDBB
BBBDDBDBDD
BBDBBDBBBB
BBDDBDBDBD
DBBDBBBBDD
DBDDBBBBDD
DDDBDBDDDD
BDBDBDDDDB
