D=D=D=D=D=D=D=D=D=D=D=D
=--------------------D-
--=D=D=D=D=-=D=D=D=D=BD
-==========-==========-
-=M-----------------M=-
-=========---=========-
-=-------D-=-D-------=-
-=M-=====D===D=====-M=-
-=-------D-=-D-------=-
-=========---=========-
-=M-----------------M=-
-==========-==========-
DB=D=D=D=D=-=D=D=D=D=--
-D--------------------=
D=D=D=D=D=D=D=D=D=D=D=D
