==DDDDDDDDDDDDDDDDDDDDDD=
==B=-=-=--==-=---==-=-=D=
=M=======-M====MM=DDDDDD=
=---------==---==D-===-==
---=====M----M==--====M==
==-==============--======
M=D-=D-D=D-D=-DD--=M=----
D-D-=D=D=D=D=-DD=-=------
D=D-=D=D-D=D=-DD=-=------
D=D--D=DMD=D--DM=--------
==DDD=D==M-=-======-=----
====-=-=====-==DDDDD=----
====---=DDDDD==-=====---D
=M---===D======----M=--MB
