===========D==D==========
===========D==D==========
===========D==D==========
===========D==D==========
===========D==D==========
===========D==D==========
===========D==D==========
DDDDDDDDDDDBDDDDDDDDDDDDD
===========D==D==========
===========D==D==========
DDDDDDDDDDDDDDBDDDDDDDDDD
===========D==D==========
===========D==D==========
===========D==D==========
===========D==D==========
===========D==D==========
===========D==D==========
===========D==D==========
