DDDDDDDDDDDDBDDDDDDDDDDDD
DWWWWWWWWWWWWWWWWWWWWWWWD
D-MDD-DDD=DWWWD=DDD-DDM-D
D-DDD-D=DDDWWWDDD=D-DDD-D
D-----DDD=DWWWD=DDD-----D
=D====-----WWW-----====D=
=DDDD=-DDMDWWWDMDD-=DDDD=
=D====-DDDDWWWDDDD-=D====
=DDDD=-DDDDWWWDDDD-=DDDD=
====D=-DDMDWWWDMDD-====D=
=DDDD=-----WWW-----=DDDD=
D-----DDD=DWWWD=DDD-----D
D-DDD-D=DDDWWWDDD=D-DDD-D
D-MDD-DDD=DWWWD=DDD-DDM-D
DWWWWWWWWWWWWWWWWWWWWWWWD
DDDDDDDDDDDDBDDDDDDDDDDDD
