BDDDDDDDDDDDDDDDDD=D
===-====-=====D-=---
=---====-====--==D-=
---=====M====M==--==
=================--=
B=D-=D-D=D-D=-DD--=M
D-D-=D=D=D=D=-DD=-=-
D=D-=D=D-D=D=-DD=-=-
D=D--D=DMD=D--DM=---
